50 50
100 100
485 485 485 485 485 485 485 485 485 485 485 485 485 485 485 485 485 485 485 485 485 485 485 485 485 485 485 485 485 485 485 485 485 485 485 485 485 485 485 485 485 485 485 485 485 485 485 485 486 487
485 485 485 485 485 485 485 485 485 485 803 803 803 485 485 485 485 485 485 485 485 485 802 802 802 485 485 485 485 485 485 485 485 485 485 486 485 485 485 525 803 803 485 485 485 485 485 485 485 486
525 525 525 525 525 525 525 525 525 525 1053 1053 1053 525 525 525 525 525 525 525 525 525 1053 1053 1053 525 525 525 525 525 525 525 525 525 525 525 525 525 525 525 1053 1053 525 525 525 525 525 525 526 527
565 565 565 565 565 565 565 565 565 565 1053 1053 1053 565 565 565 565 488 565 565 565 565 1053 1053 1053 565 565 565 565 565 565 565 565 488 565 565 565 565 565 565 1053 1053 565 565 565 488 565 565 566 567
405 406 406 406 406 406 406 406 406 406 406 406 406 406 406 406 406 406 406 406 406 406 406 406 406 406 406 406 406 406 406 406 406 406 406 406 406 406 406 406 406 406 406 406 406 406 406 406 406 407
405 406 406 406 406 406 406 406 406 406 406 406 406 406 406 406 406 406 406 406 406 406 406 406 406 406 406 406 406 406 406 406 406 406 406 406 406 406 406 406 406 406 406 406 406 406 406 406 406 407
405 406 406 406 406 406 406 406 406 406 406 406 406 406 406 406 406 406 406 406 406 406 406 406 406 406 406 406 406 406 406 406 406 406 406 406 406 406 406 406 406 406 406 406 406 406 406 406 406 407
405 406 406 406 406 406 406 406 406 406 406 406 406 406 406 406 406 406 406 406 406 406 406 406 406 406 406 406 406 406 406 406 406 406 406 406 406 406 406 406 406 406 406 406 406 406 406 406 406 407
405 406 406 406 406 406 406 406 406 406 406 406 406 406 406 406 406 406 406 406 406 406 406 406 406 406 406 406 406 406 406 406 406 406 406 406 406 406 406 406 406 406 406 406 406 406 406 406 406 407
405 406 406 406 406 406 406 406 406 406 406 406 406 406 406 406 406 406 406 406 406 406 406 406 406 406 406 406 406 406 406 406 406 406 406 406 406 406 406 406 406 406 406 406 406 406 406 406 406 407
405 406 406 406 406 406 406 406 406 406 406 406 406 406 406 406 406 406 406 406 406 406 406 406 406 406 406 406 406 406 406 406 406 406 406 406 406 406 406 406 406 406 406 406 406 406 406 406 406 407
405 406 406 406 406 406 406 406 406 406 406 406 406 406 406 406 406 406 406 406 406 406 406 406 406 406 406 406 406 406 406 406 406 406 406 406 406 406 406 406 406 406 406 406 406 406 406 406 406 407
405 406 406 406 406 406 406 406 406 406 406 406 406 406 406 406 406 406 406 406 406 406 406 406 406 406 406 406 406 406 406 406 406 406 406 406 406 406 406 406 406 406 406 406 406 406 406 406 406 407
405 406 406 406 406 406 406 406 406 406 406 406 406 406 406 406 406 406 406 406 406 406 406 406 406 406 406 406 406 406 406 406 406 406 406 406 406 406 406 406 406 406 406 406 406 406 406 406 406 407
405 406 406 406 406 406 406 406 406 406 406 406 406 406 406 406 406 406 406 406 406 406 406 406 406 406 406 406 406 406 406 406 406 406 406 406 406 406 406 406 406 406 406 406 406 406 406 406 406 407
405 406 406 406 406 406 406 406 406 406 406 406 406 406 406 406 406 406 406 406 406 406 406 406 406 406 406 406 406 406 406 406 406 406 406 406 406 406 406 406 406 406 406 406 406 406 406 406 406 407
405 406 406 406 406 406 406 406 406 406 406 406 406 406 406 406 406 406 406 406 406 406 406 406 406 406 406 406 406 406 406 406 406 406 406 406 406 406 406 406 406 406 406 406 406 406 406 406 406 407
405 406 406 406 406 406 406 406 406 406 406 406 406 406 406 406 406 406 406 406 406 406 406 406 406 406 406 406 406 406 406 406 406 406 406 406 406 406 406 406 406 406 406 406 406 406 406 406 406 407
405 406 406 406 406 406 406 406 406 406 406 406 406 406 406 406 406 406 406 406 406 406 406 406 406 406 406 406 406 406 406 406 406 406 406 406 406 406 406 406 406 406 406 406 406 406 406 406 406 407
405 406 406 406 406 406 406 406 406 406 406 406 406 406 406 406 406 406 406 406 406 406 406 406 406 406 406 406 406 406 406 406 406 406 406 406 406 406 406 406 406 406 406 406 406 406 406 406 406 407
405 406 406 406 406 406 406 406 406 406 406 406 406 406 406 406 406 406 406 406 406 406 406 406 406 406 406 406 406 406 406 406 406 406 406 406 406 406 406 406 406 406 406 406 406 406 406 406 406 407
405 406 406 406 406 406 406 406 406 406 406 406 406 406 406 406 406 406 406 406 406 406 406 406 406 406 406 406 406 406 406 406 406 406 406 406 406 406 406 406 406 406 406 406 406 406 406 406 406 407
405 406 406 406 406 406 406 406 406 406 406 406 406 406 406 406 406 406 406 406 406 406 406 406 406 406 406 406 406 406 406 406 406 406 406 406 406 406 406 406 406 406 406 406 406 406 406 406 406 284
405 406 406 406 406 406 406 406 406 406 406 406 406 406 406 406 406 406 406 406 406 406 406 406 406 406 406 406 406 406 406 406 406 406 406 406 406 406 406 406 406 406 406 406 406 406 406 406 284 284
405 406 406 406 406 406 406 406 406 406 406 406 406 406 406 406 406 406 406 406 406 406 406 406 406 406 406 406 284 284 284 284 284 284 284 284 284 284 284 284 284 284 284 284 284 284 284 284 284 284
405 406 406 406 406 406 406 406 406 406 406 406 406 406 406 406 406 406 406 406 406 406 406 406 406 406 284 284 284 284 284 284 284 284 284 284 284 284 284 284 284 284 284 284 284 284 284 284 284 284
405 406 406 406 406 406 406 406 406 406 406 406 406 406 406 406 406 406 406 406 406 406 406 406 284 284 284 284 284 284 284 284 284 284 284 284 284 284 284 284 284 284 284 284 284 284 284 284 284 284
405 406 406 406 406 406 406 406 406 406 406 406 406 406 406 406 406 406 406 406 406 406 406 284 284 284 284 284 284 284 284 284 284 284 284 284 284 284 284 284 284 284 284 284 284 284 284 284 284 284
405 406 406 406 406 406 406 406 406 406 406 406 406 406 406 406 406 406 406 406 406 406 284 284 284 284 284 284 284 284 284 284 284 284 284 284 284 284 284 284 284 284 284 284 284 284 406 406 406 407
405 406 406 406 406 406 406 406 406 406 406 406 406 406 406 406 406 406 406 406 284 284 284 284 284 284 284 284 284 284 284 284 284 284 284 284 284 284 284 284 284 284 284 284 406 406 406 406 406 407
405 406 406 406 406 406 406 406 406 406 406 406 406 406 406 406 406 406 284 284 284 284 284 284 284 284 284 284 284 284 284 284 284 284 284 284 284 284 284 284 284 284 284 284 406 406 406 406 406 407
405 406 406 406 406 406 406 406 406 406 406 406 406 406 406 406 406 284 284 284 284 284 284 284 284 284 284 284 284 284 284 284 284 284 284 284 284 284 284 284 284 284 284 284 406 406 406 406 406 407
405 406 406 406 406 406 406 406 406 406 406 406 406 406 406 406 284 284 284 284 284 284 284 284 284 284 284 284 284 284 284 284 284 284 284 284 284 284 284 284 284 284 284 284 406 406 406 406 406 407
405 406 406 406 406 406 406 406 406 406 406 406 406 406 406 406 284 284 284 284 284 284 284 284 284 284 284 284 284 284 284 284 284 284 284 284 284 284 284 284 284 284 284 284 406 406 406 406 406 407
405 406 406 406 406 406 406 406 406 406 406 406 406 406 406 406 284 284 284 284 284 284 284 284 284 284 284 284 284 284 284 284 284 284 284 284 284 284 284 284 284 284 284 284 406 406 406 406 406 407
405 406 406 406 406 406 406 406 406 406 406 406 406 406 406 284 284 284 284 284 284 284 284 284 284 284 284 284 284 284 284 284 284 284 284 284 284 284 284 284 284 284 284 284 406 406 406 406 406 407
405 406 406 406 406 406 406 406 406 406 406 406 406 406 406 284 284 284 284 284 284 284 284 284 284 284 284 284 284 284 284 284 284 284 284 284 284 284 284 284 284 284 284 284 406 406 406 406 406 407
405 406 406 406 406 406 406 406 406 406 406 406 406 406 406 284 284 284 284 284 284 284 284 284 284 284 284 284 284 284 284 284 284 284 284 284 284 284 284 284 284 284 284 406 406 406 406 406 406 407
405 406 406 406 406 406 406 406 406 406 406 406 406 406 406 284 284 284 284 284 284 284 284 284 284 284 284 284 284 284 284 284 284 284 284 284 284 284 284 284 284 284 406 406 406 406 406 406 406 407
405 406 406 406 406 406 406 406 406 406 406 406 406 406 406 406 284 284 284 284 284 284 284 284 284 284 284 284 284 284 284 284 284 284 284 284 284 284 406 406 406 406 406 406 406 406 406 406 406 407
405 406 406 406 406 406 406 406 406 406 406 406 406 406 406 406 406 406 284 284 284 284 284 284 284 284 284 284 284 284 284 284 284 406 406 406 406 406 406 406 406 406 406 406 406 406 406 406 406 407
405 406 406 406 406 406 406 406 406 406 406 406 406 406 406 406 406 406 406 284 284 284 284 284 284 284 284 284 284 406 406 406 406 406 406 406 406 406 406 406 406 406 406 406 406 406 406 406 406 407
405 406 406 406 406 406 406 406 406 406 406 406 406 406 406 406 406 406 406 406 406 284 284 284 284 284 284 406 406 406 406 406 406 406 406 406 406 406 406 406 406 406 406 406 406 406 406 406 406 407
405 406 406 406 406 406 406 406 406 406 406 406 406 406 406 406 406 406 406 406 406 406 284 284 284 284 406 406 406 406 406 406 406 406 406 406 406 406 406 406 406 406 406 406 406 406 406 406 406 407
365 406 406 406 406 406 406 406 406 406 406 406 406 406 406 406 406 406 406 406 406 406 284 284 284 284 406 406 406 406 406 406 406 406 406 406 406 406 406 406 406 406 406 406 406 406 406 406 406 407
405 406 406 406 406 406 406 406 406 406 406 406 406 406 406 406 406 406 406 406 406 406 284 284 284 284 406 406 406 406 406 406 406 406 406 406 406 406 406 406 406 406 406 406 406 406 406 406 406 407
445 446 446 446 446 446 446 446 446 446 446 446 446 446 446 446 446 446 446 446 446 446 284 284 284 284 446 446 446 446 446 446 446 446 446 446 446 446 446 446 446 446 446 446 446 446 446 446 446 447
485 486 486 486 486 486 486 486 486 486 486 486 486 486 486 486 486 486 486 486 486 486 259 260 261 261 486 486 486 486 486 486 486 486 486 486 486 486 486 486 486 486 486 486 486 486 486 486 486 487
525 526 526 526 526 526 526 526 526 526 526 526 526 526 526 526 526 526 526 526 526 526 299 300 301 301 526 526 526 526 526 526 526 526 526 526 526 526 526 526 526 526 526 526 526 526 526 526 526 527
565 566 566 566 566 566 566 566 566 566 566 566 566 566 566 566 566 566 566 566 566 566 339 340 341 341 566 566 566 566 566 566 566 566 566 566 566 566 566 566 566 566 566 566 566 566 566 566 566 565